11111111111111111111
00000000000000000000
e0000000000000000000
00000000000000000000
00000000000000000000
00000000000000000000
00000100000000000000
000001000p0000000000
00000100000000000000
00000100000000000000
00000000000000000000
00000000000000000000
00000000000000000000
00000000000000000000
11111111111111111111